10 20
####################
#..................#
#..........####....#
#.............#....#
#.............#....#
#..................#
#..................#
#.............##...#
#.............##...#
####################
2 2