20 20
####################
#..................#
#..########...###..#
#..#.#....##....#..#
#.#....#..#..#..#..#
#..##.....#........#
#......#...........#
#...#########......#
#..##..##..........#
#..#...........#...#
#..#...#.......#...#
#..#.#.........#...#
#....#..###....#...#
#.........##.......#
#..#.......#######.#
#...#......#..#....#
#....#.....#..#.#.##
#......##.....#.#..#
#..........##...#..#
####################

2 2